9476911724
1440802970
3832163671
0080587766
3742450941
3522187274
2335995409
5039709106
5542591457
0928909800
